The Tipping Point: How Little Things Can Make a Big Difference by Malcolm Gladwell
Freakonomics: A Rogue Economist Explores the Hidden Side of Everything by Steven D. Levitt
Rework by Jason Fried
Outliers: The Story of Success by Malcolm Gladwell
How to Win Friends and Influence People by Dale Carnegie
The Lean Startup: How Today's Entrepreneurs Use Continuous Innovation to Create Radically Successful Businesses by Eric Ries
Blink: The Power of Thinking Without Thinking by Malcolm Gladwell
Getting Things Done: The Art of Stress-Free Productivity by David Allen
Who Moved My Cheese? by Spencer Johnson
The E-Myth Revisited: Why Most Small Businesses Don't Work and What to Do About It by Michael E. Gerber
Steve Jobs by Walter Isaacson
Good to Great: Why Some Companies Make the Leap... and Others Don't by Jim Collins
Made to Stick: Why Some Ideas Survive and Others Die by Chip Heath
Lean In: Women, Work, and the Will to Lead by Sheryl Sandberg
Drive: The Surprising Truth About What Motivates Us by Daniel H. Pink
The Innovator's Dilemma: The Revolutionary Book That Will Change the Way You Do Business by Clayton M. Christensen
Built to Last: Successful Habits of Visionary Companies by Jim Collins
Think and Grow Rich by Napoleon Hill
The Big Short: Inside the Doomsday Machine by Michael Lewis
The Goal: A Process of Ongoing Improvement by Eliyahu M. Goldratt
Linchpin: Are You Indispensable? by Seth Godin
The One Minute Manager by Kenneth H. Blanchard
The Power of Habit: Why We Do What We Do in Life and Business by Charles Duhigg
Purple Cow: Transform Your Business by Being Remarkable by Seth Godin
Getting to Yes: Negotiating Agreement Without Giving In by Roger Fisher
Tribes: We Need You to Lead Us by Seth Godin
The Long Tail: Why the Future of Business is Selling Less of More by Chris Anderson
The World Is Flat: A Brief History of the Twenty-first Century by Thomas L. Friedman
Switch: How to Change Things When Change Is Hard by Chip Heath
First, Break All the Rules: What the World's Greatest Managers Do Differently by Marcus Buckingham
The $100 Startup: Reinvent the Way You Make a Living, Do What You Love, and Create a New Future by Chris Guillebeau
Business Model Generation: A Handbook For Visionaries, Game Changers, And Challengers by Alexander Osterwalder
Never Eat Alone: And Other Secrets to Success, One Relationship at a Time by Keith Ferrazzi
Influence: The Psychology of Persuasion by Robert B. Cialdini
Start with Why: How Great Leaders Inspire Everyone to Take Action by Simon Sinek
The Black Swan: The Impact of the Highly Improbable by Nassim Nicholas Taleb
Crucial Conversations: Tools for Talking When Stakes are High by Kerry Patterson
Winning by Jack Welch
The 21 Irrefutable Laws of Leadership by John C. Maxwell
Emotional Intelligence 2.0 by Travis Bradberry
The Dip: A Little Book That Teaches You When to Quit by Seth Godin
Execution: The Discipline of Getting Things Done by Larry Bossidy
Crossing the Chasm: Marketing and Selling High-Tech Products to Mainstream Customers by Geoffrey A. Moore
SuperFreakonomics: Global Cooling, Patriotic Prostitutes And Why Suicide Bombers Should Buy Life Insurance by Steven D. Levitt
Crush It!: Why Now Is the Time to Cash In on Your Passion by Gary Vaynerchuk
Barbarians at the Gate: The Fall of RJR Nabisco by Bryan Burrough
Thinking, Fast and Slow by Daniel Kahneman
Great by Choice: Uncertainty, Chaos, and Luck--Why Some Thrive Despite Them All by Jim Collins
The Millionaire Next Door by Thomas J. Stanley
The Effective Executive: The Definitive Guide to Getting the Right Things Done by Peter F. Drucker
