Quiet: The Power of Introverts in a World That Can't Stop Talking by Susan Cain
Blink: The Power of Thinking Without Thinking by Malcolm Gladwell
Man's Search for Meaning by Viktor E. Frankl
Thinking, Fast and Slow by Daniel Kahneman
The Tipping Point: How Little Things Can Make a Big Difference by Malcolm Gladwell
The Psychopath Test: A Journey Through the Madness Industry by Jon Ronson
The Interpretation of Dreams by Sigmund Freud
An Unquiet Mind: A Memoir of Moods and Madness by Kay Redfield Jamison
Influence: The Psychology of Persuasion by Robert B. Cialdini
Emotional Intelligence: Why It Can Matter More Than IQ by Daniel Goleman
Flow: The Psychology of Optimal Experience by Mihaly Csikszentmihalyi
Stumbling on Happiness by Daniel Gilbert
Girl, Interrupted by Susanna Kaysen
How to Win Friends and Influence People by Dale Carnegie
The Bell Jar by Sylvia Plath
Drive: The Surprising Truth About What Motivates Us by Daniel H. Pink
The Lucifer Effect: Understanding How Good People Turn Evil by Philip G. Zimbardo
Civilization and Its Discontents by Sigmund Freud
The Sociopath Next Door: The Ruthless Versus the Rest of Us by Martha Stout
How We Decide by Jonah Lehrer
Games People Play by Eric Berne
Memories, Dreams, Reflections by C.G. Jung
The Road Less Traveled:  A New Psychology of Love, Traditional Values, and Spiritual Growth by M. Scott Peck
The Art of Loving by Erich Fromm
One Flew Over the Cuckoo's Nest by Ken Kesey
The Curious Incident of the Dog in the Night-Time by Mark Haddon
Musicophilia: Tales of Music and the Brain by Oliver Sacks
Love's Executioner and Other Tales of Psychotherapy by Irvin D. Yalom
You Are Not So Smart: Why You Have Too Many Friends on Facebook, Why Your Memory Is Mostly Fiction, and 46 Other Ways You're Deluding Yourself by David McRaney
The Blank Slate: The Modern Denial of Human Nature by Steven Pinker
How the Mind Works by Steven Pinker
Moonwalking with Einstein: The Art and Science of Remembering Everything by Joshua Foer
Freakonomics: A Rogue Economist Explores the Hidden Side of Everything by Steven D. Levitt
The Paradox of Choice: Why More Is Less by Barry Schwartz
The Gift of Therapy: An Open Letter to a New Generation of Therapists and Their Patients by Irvin D. Yalom
The Brain That Changes Itself: Stories of Personal Triumph from the Frontiers of Brain Science by Norman Doidge
Emotional Intelligence 2.0 by Travis Bradberry
The Language Instinct: How the Mind Creates Language by Steven Pinker
Reviving Ophelia: Saving the Selves of Adolescent Girls by Mary Pipher
Prozac Nation by Elizabeth Wurtzel
The Highly Sensitive Person by Elaine N. Aron
On Becoming a Person: A Therapist's View of Psychotherapy by Carl R. Rogers
The Happiness Hypothesis: Finding Modern Truth in Ancient Wisdom by Jonathan Haidt
Phantoms in the Brain: Probing the Mysteries of the Human Mind by V.S. Ramachandran
The Power of Habit: Why We Do What We Do in Life and Business by Charles Duhigg
Incognito: The Secret Lives of the Brain by David Eagleman
The Upside of Irrationality: The Unexpected Benefits of Defying Logic at Work and at Home by Dan Ariely
The Invisible Gorilla: And Other Ways Our Intuitions Deceive Us by Christopher Chabris
The Moral Animal: Why We Are the Way We Are: The New Science of Evolutionary Psychology by Robert Wright
Nudge: Improving Decisions About Health, Wealth, and Happiness by Richard H. Thaler
