A Short History of Nearly Everything by Bill Bryson
The Selfish Gene by Richard Dawkins
The Immortal Life of Henrietta Lacks by Rebecca Skloot
The Elegant Universe: Superstrings, Hidden Dimensions, and the Quest for the Ultimate Theory by Brian Greene
Cosmos by Carl Sagan
The Origin of Species by Charles Darwin
The Demon-Haunted World: Science as a Candle in the Dark by Carl Sagan
The Greatest Show on Earth: The Evidence for Evolution by Richard Dawkins
Stiff: The Curious Lives of Human Cadavers by Mary Roach
The God Delusion by Richard Dawkins
Surely You're Joking, Mr. Feynman! by Richard P. Feynman
Guns, Germs, and Steel: The Fates of Human Societies by Jared Diamond
The Disappearing Spoon: And Other True Tales of Madness, Love, and the History of the World from the Periodic Table of the Elements by Sam Kean
The Grand Design by Stephen Hawking
The Fabric of the Cosmos by Brian Greene
Packing for Mars: The Curious Science of Life in the Void by Mary Roach
Bonk: The Curious Coupling of Science and Sex by Mary Roach
The Man Who Mistook His Wife for a Hat and Other Clinical Tales by Oliver Sacks
Death by Black Hole: And Other Cosmic Quandaries by Neil deGrasse Tyson
Physics of the Impossible: A Scientific Exploration into the World of Phasers, Force Fields, Teleportation, and Time Travel by Michio Kaku
The Ancestor's Tale: A Pilgrimage to the Dawn of Evolution by Richard Dawkins
Bad Science by Ben Goldacre
Gödel, Escher, Bach: An Eternal Golden Braid by Douglas R. Hofstadter
Pale Blue Dot: A Vision of the Human Future in Space by Carl Sagan
Chaos: The Making of a New Science by James Gleick
The Emperor of All Maladies by Siddhartha Mukherjee
The Hot Zone by Richard   Preston
Genome: the Autobiography of a Species in 23 Chapters by Matt Ridley
Your Inner Fish: A Journey into the 3.5-Billion-Year History of the Human Body by Neil Shubin
The Structure of Scientific Revolutions by Thomas S. Kuhn
Longitude: The True Story of a Lone Genius Who Solved the Greatest Scientific Problem of his Time by Dava Sobel
Spook: Science Tackles the Afterlife by Mary Roach
The World Without Us by Alan Weisman
A Universe from Nothing: Why There Is Something Rather Than Nothing by Lawrence M. Krauss
Gulp: Adventures on the Alimentary Canal by Mary Roach
The Hidden Reality: Parallel Universes and the Deep Laws of the Cosmos by Brian Greene
A Briefer History of Time by Stephen Hawking
Relativity: The Special and the General Theory by Albert Einstein
Hyperspace: A Scientific Odyssey through Parallel Universes, Time Warps, and the Tenth Dimension by Michio Kaku
Dragons of Eden: Speculations on the Evolution of Human Intelligence by Carl Sagan
Freakonomics: A Rogue Economist Explores the Hidden Side of Everything by Steven D. Levitt
Thinking, Fast and Slow by Daniel Kahneman
The Magic of Reality: How We Know What's Really True by Richard Dawkins
The Third Chimpanzee: The Evolution & Future of the Human Animal by Jared Diamond
The Botany of Desire: A Plant's-Eye View of the World by Michael Pollan
Musicophilia: Tales of Music and the Brain by Oliver Sacks
Parallel Worlds: A Journey Through Creation, Higher Dimensions, and the Future of the Cosmos by Michio Kaku
Blink: The Power of Thinking Without Thinking by Malcolm Gladwell
The Poisoner's Handbook: Murder and the Birth of Forensic Medicine in Jazz Age New York by Deborah Blum
Billions & Billions: Thoughts on Life and Death at the Brink of the Millennium by Carl Sagan
